111111111111111111
11C010010000000001
11CE10011111111111
11P010010000000001
111111111111111111