11111111111111111111
10000000000000000001
1C0P0000000C00000001
11111111111111110011
1C00010C010000100001
10010001010C0010CC01
1101111100010010CC01
10000C10000100000001
11111011111111111111
100C000010000100CC01
10CCC000101101000001
100C000010E1000CCCC1
11110111111111011111
10C000C000C000C000C1
1000C000C000C000C001
11111111111111111111