1111111111111
100P00E00C001
1111111111111